2;2;2;2;2;2;2;2;2;2;2;2;2;2;2;2;2;2;2;2
2;1;1;1;10;1;1;1;1;1;1;1;1;1;1;1;1;1;1;2
2;1;17;1;1;1;1;1;1;1;1;1;1;1;1;1;1;1;1;2
2;1;1;1;1;1;1;1;1;1;1;4;1;1;1;1;1;1;1;2
2;1;1;1;1;1;1;1;1;1;1;1;1;1;1;1;1;1;1;2
2;3;1;1;1;1;1;1;1;1;1;1;1;1;1;1;1;18;1;2
2;1;1;1;1;1;1;1;1;1;1;1;1;1;1;1;1;1;1;2
2;20;1;1;1;1;1;1;1;1;1;1;1;1;1;1;1;1;1;2
2;19;1;12;1;1;1;1;1;1;1;1;1;1;1;1;1;1;1;2
2;1;1;1;1;1;1;1;1;1;1;1;1;1;1;1;1;1;1;2
2;1;1;1;1;1;1;1;1;1;1;1;1;11;1;1;1;4;1;2
2;1;1;1;1;1;1;1;1;1;1;1;1;1;1;1;1;1;1;2
2;1;1;1;1;1;1;1;1;1;1;1;1;1;1;1;1;1;1;2
2;1;1;1;21;1;1;1;1;1;1;1;1;1;1;1;1;1;1;2
2;1;1;1;1;1;1;1;1;1;1;1;1;1;1;1;1;1;1;2
2;1;1;1;1;1;1;1;1;1;1;1;1;1;1;1;1;1;1;2
2;1;1;1;1;1;1;1;1;1;1;1;1;1;14;1;1;1;1;2
2;1;1;1;1;1;1;1;1;1;1;1;1;1;1;1;1;1;1;2
2;1;1;1;13;1;1;1;1;1;1;3;1;1;1;1;1;1;1;2
2;1;1;1;1;16;1;1;1;1;1;1;1;1;15;1;1;1;1;2
2;2;2;2;2;2;2;2;2;2;2;2;2;2;2;2;2;2;2;2